36 35 35 35 35 35 35 35 35 35 35 35 35 35 35 35 35 35 35 35 35 35 35 44 99 99 99 99 99 99 99 99 99 99 99 99 99 99 99 99 99 99 99 99 99 99 99 99 99 99 99 99 99 99 99 99 99 99 99 99 99 99 99 99 99 99 99 99 99 99 99 99 99 99 99 99 99 99 99 99 99 99 99 99 99 99 99 99 99 99 99 99 99 99 99 99 99 99 99 99
33 37 37 37 37 37 37 37 37 37 37 37 37 52 50 37 37 37 37 37 37 37 37 33 99 99 99 99 99 99 99 99 99 99 99 99 99 99 99 99 99 99 99 99 99 99 99 99 99 99 99 99 99 99 99 99 99 99 99 99 99 99 99 99 99 99 99 99 99 99 99 99 99 99 99 99 99 99 99 99 99 99 99 99 99 99 99 99 99 99 99 99 99 99 99 99 99 99 99 99
33 38 38 38 38 38 38 38 38 38 38 38 38 51 49 38 38 38 38 38 38 38 38 33 99 99 99 36 35 35 35 35 35 35 35 35 35 35 35 35 35 35 44 99 99 99 99 99 99 36 35 35 35 35 35 35 35 35 44 99 99 99 99 99 99 99 99 99 99 99 99 99 99 99 99 99 99 99 99 99 99 99 99 99 99 99 99 99 99 99 99 99 99 99 99 99 99 99 99 99
33 10 10 10 10 10 10 10 10 10 10 10 10 10 10 10 10 10 10 10 10 10 10 33 99 99 99 33 37 37 37 37 37 37 37 37 37 37 37 37 37 37 33 99 99 99 99 99 99 33 37 37 37 37 37 37 37 37 33 99 99 99 99 99 99 99 99 99 99 99 99 99 99 99 99 99 99 99 99 99 99 99 99 99 99 99 99 99 99 99 99 99 99 99 99 99 99 99 99 99
33 10 10 10 10 10 10 10 10 10 10 10 10 10 10 10 10 10 10 10 10 10 10 33 99 99 99 33 13 13 13 13 13 13 13 13 13 13 13 13 13 13 33 99 99 99 99 99 99 33 13 13 13 13 13 13 13 13 33 99 99 99 99 99 99 99 99 99 99 99 99 99 99 99 99 99 99 99 99 99 99 99 99 99 99 99 99 99 99 99 99 99 99 99 99 99 99 99 99 99
33 10 10 10 10 10 10 10 10 10 10 10 10 10 10 10 10 10 10 10 10 10 10 33 99 99 99 33 10 10 10 10 10 10 10 10 10 10 10 10 10 10 33 99 99 99 99 99 99 33 10 10 10 10 10 10 10 10 33 99 99 99 99 99 99 99 99 99 99 99 99 99 99 99 99 99 99 99 99 99 99 99 99 99 99 99 99 99 99 99 99 99 99 99 99 99 99 99 99 99
33 10 10 10 10 10 10 10 10 10 10 10 10 10 10 10 10 10 10 10 10 10 10 33 99 99 99 33 10 10 10 10 10 10 10 10 10 10 10 10 10 10 33 99 99 99 99 99 99 33 10 10 10 10 10 10 10 10 33 99 99 99 99 99 99 99 99 99 99 99 99 99 99 99 99 99 99 99 99 99 99 99 99 99 99 99 99 99 99 99 99 99 99 99 99 99 99 99 99 99
33 10 10 10 10 10 10 10 10 10 10 10 10 10 10 10 10 10 10 10 10 10 10 33 99 99 99 33 10 10 10 10 10 10 10 10 10 10 10 10 10 10 33 99 99 99 99 99 99 33 10 10 10 10 10 10 10 10 33 99 99 99 99 99 99 99 99 99 99 99 99 99 99 99 99 99 99 99 99 99 99 99 99 99 99 99 99 99 99 99 99 99 99 99 99 99 99 99 99 99
33 10 10 10 10 10 10 10 10 10 10 10 10 10 10 10 10 10 10 10 10 10 10 33 99 99 99 33 10 10 10 10 10 10 10 10 10 10 10 10 10 10 33 99 99 99 99 99 99 33 10 10 10 10 10 10 10 10 33 99 99 99 99 99 99 99 99 99 99 99 99 99 99 99 99 99 99 99 99 99 99 99 99 99 99 99 99 99 99 99 99 99 99 99 99 99 99 99 99 99
33 10 10 10 10 10 10 10 10 10 10 10 10 10 10 10 10 10 10 10 10 10 10 33 99 99 99 33 10 10 10 10 10 10 10 10 10 10 10 10 10 10 33 99 99 99 99 99 99 33 10 10 10 10 10 10 10 10 33 99 99 99 99 99 99 99 99 99 99 99 99 99 99 99 99 99 99 99 99 99 99 99 99 99 99 99 99 99 99 99 99 99 99 99 99 99 99 99 99 99
33 10 10 10 10 10 10 10 10 10 10 10 10 10 10 10 10 10 10 10 10 10 10 46 35 35 35 35 32 10 10 41 35 35 35 35 35 35 35 35 35 35 35 35 35 35 35 35 35 35 32 10 10 41 35 35 35 35 35 35 35 35 35 35 35 35 35 35 35 35 35 35 35 35 35 35 35 35 35 35 35 35 35 44 99 99 99 99 99 99 99 99 10 10 10 10 10 10 10 99
33 10 10 10 10 10 10 10 10 10 10 10 10 10 10 10 10 10 10 10 10 10 10 47 37 39 37 37 31 10 10 42 37 37 37 37 37 37 37 37 37 37 37 37 37 37 37 37 37 37 31 10 10 42 37 37 37 37 37 37 37 37 37 37 37 37 37 37 37 37 37 37 37 37 37 37 37 33 37 37 37 37 37 33 99 99 99 99 99 99 99 99 10 10 10 10 10 10 10 99
33 10 10 10 10 10 10 10 10 10 10 10 10 10 10 10 10 10 10 10 10 10 10 48 38 40 38 38 30 10 10 43 38 38 38 38 38 38 38 38 38 38 38 38 38 38 38 38 38 38 30 10 10 43 38 38 38 38 38 38 38 38 38 38 38 38 38 38 38 38 38 38 38 38 38 38 38 60 38 38 38 38 38 33 99 99 99 99 99 99 99 99 10 10 10 10 10 10 10 99
33 10 10 10 10 10 10 10 10 10 10 10 10 10 10 10 10 10 10 10 10 10 10 10 10 10 10 10 10 10 10 10 10 10 10 10 10 10 10 10 10 10 10 10 10 10 10 10 10 10 10 10 10 10 10 10 10 10 10 10 10 10 10 10 10 10 10 10 10 10 10 10 10 10 10 10 10 61 10 10 10 10 10 33 99 99 99 99 99 99 99 99 10 10 10 10 10 10 10 99
33 10 10 10 10 10 10 10 10 10 10 10 10 10 10 10 10 10 10 10 10 10 10 10 10 10 10 10 10 10 10 10 10 10 10 10 10 10 10 10 10 10 10 10 10 10 10 10 10 10 10 10 10 10 10 10 10 10 10 10 10 10 10 10 10 10 10 10 10 10 10 10 10 10 10 10 10 62 10 10 10 10 10 33 99 99 99 99 99 99 99 99 10 10 10 10 10 10 10 99
33 10 10 10 10 10 10 10 10 10 10 10 10 10 10 10 10 10 10 10 10 10 10 10 10 10 10 10 10 10 10 10 10 10 10 10 10 10 10 10 10 10 10 10 10 10 10 10 10 10 10 10 10 10 10 10 10 10 10 10 10 10 10 10 10 10 10 10 10 10 10 10 10 10 10 10 10 10 10 10 10 10 10 33 99 99 99 99 99 99 99 99 10 10 10 10 10 10 10 99
33 10 10 10 10 10 10 10 10 10 10 10 10 10 10 10 10 10 10 10 10 10 10 10 10 10 10 10 10 10 10 10 10 10 10 10 10 10 10 10 10 10 10 10 10 10 10 10 10 10 10 10 10 10 10 10 10 10 10 10 10 10 10 10 10 10 10 10 10 10 10 10 10 10 10 10 10 10 10 10 10 10 10 33 99 99 99 99 99 99 99 99 10 10 10 10 10 10 10 99
33 10 10 10 10 10 10 10 10 10 10 10 10 10 10 10 10 10 10 10 10 10 10 36 35 35 35 35 35 35 35 35 35 35 35 35 35 35 10 10 10 10 35 35 35 35 35 35 35 35 35 35 35 35 32 10 10 10 41 35 35 35 35 35 35 35 35 35 35 35 35 35 35 35 35 35 35 35 35 35 35 35 35 33 99 99 99 99 99 99 99 99 10 10 10 10 10 10 10 99
33 10 10 10 10 10 10 10 10 10 10 10 10 10 10 10 10 10 10 10 10 10 10 33 37 37 37 37 37 37 37 37 37 37 37 37 37 37 10 10 10 10 37 37 37 37 37 37 37 37 37 37 37 37 31 10 10 10 42 37 37 37 33 37 37 37 37 37 37 33 37 84 84 84 84 84 84 84 84 84 84 84 37 33 99 99 99 99 99 99 99 99 10 10 10 10 10 10 10 99
33 10 10 10 10 10 10 10 10 10 10 10 10 10 10 10 10 10 10 10 10 10 10 33 38 38 38 38 38 38 38 38 38 38 38 38 38 38 10 10 10 10 38 38 38 38 38 38 38 38 38 38 38 38 30 10 10 10 43 38 38 38 33 38 38 38 38 38 38 33 38 85 85 85 85 85 85 85 85 85 85 85 38 33 99 99 99 99 99 99 99 99 10 10 10 10 10 10 10 99
33 10 10 10 10 10 10 10 10 10 10 10 10 10 10 10 10 10 10 10 10 10 10 33 99 99 99 99 99 99 99 99 99 99 99 99 99 99 63 69 74 79 99 99 99 99 99 99 99 33 10 10 10 10 10 10 10 10 10 10 10 10 33 10 10 10 10 10 10 33 10 86 86 86 86 86 86 86 86 86 86 86 10 33 99 99 99 99 99 99 99 99 10 10 10 10 10 10 10 99
33 10 10 10 10 10 10 10 10 10 10 10 10 10 10 10 10 10 10 10 10 10 10 33 99 99 99 99 99 99 99 99 99 99 99 99 99 99 64 70 75 80 99 99 99 99 99 99 99 33 10 10 10 10 10 10 10 10 10 10 10 10 33 10 10 10 10 10 10 33 10 10 10 10 10 10 10 10 10 10 10 10 10 33 99 99 99 99 99 99 99 99 10 10 10 10 10 10 10 99
33 10 10 10 10 10 10 10 10 10 10 10 10 10 10 10 10 10 10 10 10 10 10 33 99 99 99 99 99 99 99 99 99 99 99 99 99 99 65 71 76 81 99 99 99 99 99 99 99 33 10 10 10 10 10 10 10 10 10 10 10 10 33 10 10 10 10 10 10 33 10 10 10 10 10 10 10 10 10 10 10 10 10 33 99 99 99 99 99 99 99 99 99 99 99 99 99 99 99 99
33 10 10 10 10 10 10 10 10 10 10 10 10 10 10 10 10 10 10 10 10 10 11 33 99 99 99 99 99 99 99 99 99 99 99 99 99 99 66 72 77 82 99 99 99 99 99 99 99 33 10 10 10 10 10 10 10 10 10 10 10 10 46 35 35 35 35 35 35 45 10 10 10 10 10 10 10 10 10 10 10 10 10 33 99 99 99 99 99 99 99 99 99 99 99 99 99 99 99 99
33 10 10 10 10 10 10 10 10 10 10 10 10 10 10 10 10 10 10 10 10 10 11 33 99 99 99 99 99 99 99 99 99 99 99 99 99 99 67 73 78 83 99 99 99 99 99 99 99 33 10 10 10 10 10 10 10 10 10 10 10 10 47 37 37 37 37 37 37 37 10 10 10 10 10 10 10 10 10 10 10 10 10 33 99 99 99 99 99 99 99 99 99 99 99 99 99 99 99 99
33 10 10 10 10 10 10 10 10 10 10 10 10 10 10 10 10 10 10 10 10 10 11 33 99 99 99 99 99 99 10 10 10 10 10 10 99 10 68 10 10 10 99 99 99 99 99 99 99 33 10 10 10 10 10 10 10 10 10 10 10 10 48 38 38 38 38 38 38 38 10 10 10 10 10 10 10 10 10 10 10 10 10 33 99 99 99 99 99 99 99 99 99 99 99 99 99 99 99 99
33 10 10 10 10 10 10 10 10 10 10 10 10 10 10 10 10 10 10 10 10 10 11 33 99 99 99 99 99 99 10 10 10 10 10 10 99 10 10 10 10 10 99 99 99 99 99 99 99 33 10 10 10 10 10 10 10 10 10 10 10 10 10 10 10 10 10 10 10 10 10 10 10 10 10 10 10 10 10 10 10 10 10 33 99 99 99 99 99 99 99 99 99 99 99 99 99 99 99 99
33 10 10 10 10 10 10 10 10 10 10 10 10 10 10 10 10 10 10 10 10 10 11 33 99 99 99 99 99 99 10 10 10 10 10 10 99 10 10 10 10 10 99 99 99 99 99 99 99 33 10 10 10 10 10 10 10 10 10 10 10 10 10 10 10 10 10 10 10 10 10 10 10 10 10 10 10 10 10 10 10 10 10 33 99 99 99 99 99 99 99 99 99 99 99 99 99 99 99 99
33 10 10 10 10 10 10 10 10 10 10 10 10 10 10 10 10 10 10 10 10 10 11 33 99 99 99 99 99 99 10 10 10 10 10 10 99 10 10 10 10 10 99 99 99 99 99 99 99 33 10 10 10 10 10 10 10 10 10 10 10 10 10 10 10 10 10 10 10 10 10 10 10 10 10 10 10 10 10 10 10 10 10 33 99 99 99 99 99 99 99 99 99 99 99 99 99 99 99 99
33 10 10 10 10 10 10 10 10 10 10 10 10 10 10 10 10 10 10 10 10 10 10 33 99 99 99 99 99 99 10 10 10 10 10 10 99 10 10 10 10 10 99 99 99 99 99 99 99 33 10 10 10 10 10 10 10 10 10 10 10 10 10 10 10 10 10 10 10 10 10 10 10 10 10 10 10 10 10 10 10 10 10 33 99 99 99 99 99 99 99 99 99 99 99 99 99 99 99 99
33 10 10 10 10 10 10 10 10 10 10 10 10 10 10 10 10 10 10 10 10 10 10 33 99 99 99 99 99 99 10 10 10 10 10 10 99 10 10 10 10 10 99 99 99 99 99 99 99 33 10 10 10 10 10 10 10 10 10 10 10 10 10 10 10 10 10 10 10 10 10 10 10 10 10 10 10 10 10 10 10 10 10 33 99 99 99 99 99 99 99 99 99 99 99 99 99 99 99 99
33 10 10 10 10 10 10 10 10 10 10 10 10 10 10 10 10 10 10 10 10 10 10 33 99 99 99 99 99 99 10 10 10 10 10 10 99 10 10 10 10 10 99 99 99 99 99 99 99 33 10 10 10 10 10 10 10 10 10 10 10 10 10 10 10 10 10 10 10 10 10 10 10 10 10 10 10 10 10 10 10 10 10 33 99 99 99 99 99 99 99 99 99 99 99 99 99 99 99 99
33 10 10 10 10 10 10 10 10 10 10 10 10 10 10 10 10 10 10 10 10 10 10 33 99 99 99 99 99 99 10 10 10 10 10 10 99 10 10 10 10 10 99 99 99 99 99 99 99 33 10 10 10 10 10 10 10 10 10 10 10 10 10 10 10 10 10 10 10 10 10 10 10 10 10 10 10 10 10 10 10 10 10 33 99 99 99 99 99 99 99 99 99 99 99 99 99 99 99 99
34 35 35 35 35 35 35 35 35 35 35 35 35 35 35 35 35 10 10 10 35 35 35 35 35 35 35 35 35 35 35 35 35 35 35 35 35 35 35 35 35 35 35 35 35 35 35 35 35 35 35 35 35 35 35 35 35 35 35 35 35 35 35 35 35 35 35 35 35 35 35 35 35 35 35 35 35 35 35 35 35 35 35 45 99 99 99 99 99 99 99 99 99 99 99 99 99 99 99 99
99 99 99 99 99 99 99 99 99 99 99 99 99 99 99 99 99 99 99 99 99 99 99 99 99 99 99 99 99 99 99 99 99 99 99 99 99 99 99 99 99 99 99 99 99 99 99 99 99 99 99 99 99 99 99 99 99 99 99 99 99 99 99 99 99 99 99 99 99 99 99 99 99 99 99 99 99 99 99 99 99 99 99 99 99 99 99 99 99 99 99 99 99 99 99 99 99 99 99 99
