101 101 101 101 101 101 101 101 101 101 101 101 101 101 101 101 101 101 101 101 101 101 101 101 101 101 101 101 101 101 101 101 101 101 101 101 101 101 101 101 101 101 101 101 101 101 101 101 101 101 101 101 101 101 101 101 101 101 101 101 101 101 101 101 101 101 101 101 101 101 101 101 101 101 101 101 101 101 101 101 101 101 101 101 101 101 101 101 101 101
101 101 101 101 101 101 101 101 101 101 101 101 101 101 101 101 101 101 101 101 101 101 101 101 101 101 101 101 101 101 101 101 101 101 101 101 101 101 101 101 101 101 101 101 101 101 101 101 101 101 101 101 101 101 101 101 101 101 101 101 101 101 101 101 101 101 101 101 101 101 101 101 101 101 101 101 101 101 101 101 101 101 101 101 101 101 101 101 101 101
101 101 101 101 101 101 101 101 101 101 101 101 101 101 101 101 101 101 101 101 101 101 101 101 101 101 101 101 101 101 101 101 101 101 101 101 101 101 101 101 101 101 101 101 101 101 101 101 101 101 101 101 101 101 101 101 101 101 101 101 101 101 101 101 101 101 101 101 101 101 101 101 101 101 101 101 101 101 101 101 101 101 101 101 101 101 101 101 101 101
101 101 101 101 101 101 101 101 101 101 101 101 101 101 101 101 101 101 101 101 101 101 101 101 101 101 101 101 101 101 101 101 101 101 101 101 101 101 101 101 101 101 101 101 101 101 101 101 101 101 101 101 101 101 101 101 101 101 101 101 101 101 101 101 101 101 101 101 101 101 101 101 101 101 101 101 101 101 101 101 101 101 101 101 101 101 101 101 101 101
101 101 101 101 101 101 101 101 101 101 101 101 101 101 101 101 101 101 101 101 101 101 101 101 101 101 101 101 101 101 101 101 101 101 101 101 101 101 101 101 101 101 101 101 101 101 101 101 101 101 101 101 101 101 101 101 101 101 101 101 101 101 101 101 101 101 101 101 101 101 101 101 101 101 101 101 101 101 101 101 101 101 101 101 101 101 101 101 101 101
101 101 101 101 101 101 101 101 101 101 101 101 101 101 101 101 101 101 101 101 101 101 101 101 101 101 101 101 101 101 101 101 101 101 101 101 101 101 101 101 101 101 101 101 101 101 101 101 101 101 101 101 101 101 101 101 101 101 101 101 101 101 101 101 101 101 101 101 101 101 101 101 101 101 101 101 101 101 101 101 105 104 104 104 104 104 104 104 106 101
101 101 101 101 101 101 101 101 101 101 101 101 101 101 101 101 101 101 101 101 101 101 101 101 101 101 101 101 101 101 101 101 101 101 101 101 101 101 101 101 101 101 101 101 101 101 101 101 101 101 101 101 101 105 104 104 104 104 104 104 104 106 101 101 101 101 101 101 101 101 101 101 101 101 101 101 101 101 101 101 103 109 109 109 109 109 109 109 103 101
101 101 101 101 101 101 101 101 101 101 101 101 101 101 101 101 101 101 101 101 101 101 101 101 101 101 101 101 101 101 101 101 101 101 101 101 101 101 101 101 101 101 101 101 101 101 101 101 101 101 101 101 101 103 109 109 160 161 162 109 109 103 101 101 101 101 101 101 101 101 101 101 101 101 101 101 101 101 101 101 103 110 110 110 110 110 110 110 103 101
101 101 101 101 101 101 101 101 101 101 101 101 101 101 101 101 101 101 101 101 101 101 101 101 101 101 101 101 101 101 101 101 101 101 101 101 101 101 101 101 101 101 101 101 101 101 101 101 101 101 101 101 101 103 155 110 163 164 165 110 155 103 101 101 101 101 101 101 101 101 101 101 101 101 101 101 101 101 101 101 103 102 102 102 102 102 102 102 103 101
101 101 101 101 101 101 101 101 101 101 101 101 101 101 101 101 101 101 101 101 101 101 101 101 101 101 101 101 101 101 101 101 101 101 101 101 101 101 101 101 101 101 101 101 101 101 101 101 101 101 101 101 101 103 156 102 102 102 102 102 156 103 101 101 101 101 101 101 101 101 101 101 101 101 101 101 101 101 101 101 103 102 102 102 102 102 102 102 103 101
101 101 101 101 101 101 101 101 101 101 101 101 101 101 101 101 101 101 101 101 101 101 101 101 101 101 101 101 101 101 101 101 101 101 101 101 101 101 101 101 101 101 101 101 101 101 101 101 101 101 101 101 101 103 102 102 176 177 102 102 102 103 101 101 101 101 101 101 101 101 101 101 101 101 101 101 101 101 101 101 103 102 102 102 102 102 102 102 103 101
101 101 101 101 101 101 101 101 101 101 101 101 101 101 101 101 101 101 101 101 101 101 101 101 101 101 101 101 101 101 101 101 101 101 101 101 101 101 101 101 101 101 101 101 101 101 101 101 101 101 101 101 101 103 102 102 178 179 102 102 102 103 101 101 101 101 101 101 101 101 101 101 101 101 101 101 101 101 101 101 103 102 102 102 102 102 102 102 103 101
101 101 101 101 101 101 101 101 101 101 101 101 101 101 101 101 101 101 101 101 101 101 101 101 101 101 101 101 101 101 101 101 101 101 101 101 101 101 101 101 101 101 101 101 101 101 101 101 101 101 101 101 101 103 102 102 102 102 102 102 102 103 101 101 101 101 101 101 101 101 101 101 101 101 101 101 101 101 101 101 103 102 102 102 102 102 102 102 103 101
101 101 101 101 101 101 101 101 101 101 101 101 101 101 101 101 101 101 101 101 101 101 101 101 101 101 101 101 101 101 101 101 101 101 101 101 101 101 101 101 101 101 101 101 101 101 101 101 101 101 101 101 101 103 102 102 102 102 102 102 102 103 101 101 101 101 101 101 101 101 101 101 101 101 101 101 101 101 101 101 103 102 102 102 102 102 102 102 103 101
105 104 104 104 104 104 104 104 104 104 104 104 104 104 104 104 104 104 104 104 104 104 104 104 104 104 104 104 104 104 104 104 104 104 104 104 104 104 104 104 104 104 104 104 104 104 104 104 106 101 101 101 101 103 102 143 144 102 143 144 102 103 101 101 101 101 101 101 101 101 101 101 101 101 101 101 101 101 101 101 103 102 102 102 102 102 102 102 103 101
103 109 109 109 126 127 196 197 126 127 109 109 109 109 126 127 196 197 126 127 109 109 109 103 109 208 211 211 208 208 211 211 109 103 109 109 109 126 127 109 109 109 126 127 109 109 109 109 103 101 101 101 101 103 102 145 146 102 145 146 102 103 101 101 101 101 101 101 101 101 101 101 101 101 101 101 101 101 101 101 103 102 102 102 102 102 102 102 103 101
103 147 110 110 128 129 198 199 128 129 110 149 149 110 128 129 198 199 128 129 110 110 147 103 110 209 212 212 209 209 212 212 110 103 151 110 110 128 129 110 110 110 128 129 110 110 110 153 103 101 101 101 101 103 102 102 102 102 102 102 102 103 101 101 101 101 101 101 101 101 101 101 101 101 101 101 101 101 101 101 103 102 102 102 102 102 102 102 103 101
103 148 102 102 102 102 102 102 102 102 102 150 150 102 102 102 102 102 102 102 102 102 148 103 102 210 213 213 210 210 213 213 102 103 152 102 139 140 102 102 139 140 102 102 102 102 102 154 103 101 101 101 101 103 102 102 102 102 102 102 102 103 101 101 101 101 101 101 101 101 101 101 101 101 101 101 101 101 101 101 103 102 102 102 102 102 102 102 103 101
103 102 102 102 102 102 102 102 102 102 102 102 102 102 102 102 102 102 102 102 102 102 102 103 102 102 102 102 102 102 102 102 102 103 102 102 141 142 102 102 141 142 102 102 102 102 102 102 103 101 101 101 101 103 102 143 144 102 143 144 102 103 101 101 101 101 101 101 101 101 101 101 101 101 101 101 101 101 101 101 103 102 102 102 102 102 102 102 103 101
103 102 102 102 102 102 102 102 102 102 102 102 102 102 102 102 102 102 102 102 102 102 102 103 244 102 102 102 102 102 102 102 245 103 102 102 102 102 102 102 102 102 102 102 102 102 102 157 103 101 101 101 101 103 102 145 146 102 145 146 102 103 101 101 101 101 101 101 101 101 101 101 101 101 101 101 101 101 101 101 103 102 102 102 102 102 102 102 103 101
103 102 102 102 102 102 102 102 102 102 102 102 102 102 102 102 102 102 102 102 102 102 102 103 244 102 102 102 102 102 102 102 245 103 102 102 102 102 102 102 102 102 102 102 102 102 102 158 103 101 101 101 101 103 102 102 102 102 102 102 102 103 101 101 101 101 101 101 101 101 101 101 101 101 101 101 101 101 101 101 103 102 102 102 102 102 102 102 103 101
103 102 102 102 102 102 102 102 102 102 102 102 102 102 102 102 102 102 102 102 102 102 102 103 244 102 102 102 102 102 102 102 245 103 102 102 102 102 102 102 102 102 102 102 102 102 102 159 103 101 101 101 101 103 102 102 102 102 102 102 102 103 101 101 101 101 101 101 101 101 101 101 101 101 101 101 101 101 101 101 103 102 102 102 102 102 102 102 103 101
103 102 102 102 102 102 102 102 102 102 102 102 102 102 102 102 102 102 102 102 102 102 102 103 102 102 102 102 102 102 102 102 102 103 102 102 102 102 139 140 102 102 139 140 102 102 102 102 103 101 101 101 101 103 102 102 102 102 102 102 102 103 101 101 101 101 101 101 101 101 101 101 101 101 101 101 101 101 101 101 103 102 102 102 102 102 102 102 103 101
103 102 102 102 102 102 102 102 102 102 102 102 102 102 102 102 102 102 102 102 102 102 102 103 102 102 102 102 102 102 102 102 102 103 102 102 102 102 141 142 102 102 141 142 102 102 102 102 103 101 101 101 101 103 102 102 102 102 102 102 102 103 101 101 101 101 101 101 101 101 101 101 101 101 101 101 101 101 101 101 103 102 102 102 102 102 102 102 103 101
103 102 102 102 102 102 102 102 102 102 102 102 102 102 102 102 102 102 102 102 102 102 102 117 104 104 111 102 102 114 104 104 104 104 111 102 102 114 104 104 104 104 104 104 104 104 104 104 104 104 104 104 104 104 111 102 102 114 104 104 104 104 104 104 104 104 104 104 104 104 104 106 101 101 101 101 101 101 101 101 103 102 102 102 102 102 102 102 103 101
103 102 102 102 102 102 102 102 130 131 132 102 102 102 102 102 102 102 102 102 102 102 102 118 109 109 112 102 102 115 109 109 109 109 112 102 102 115 109 109 109 109 109 109 109 109 109 109 109 109 109 109 109 109 112 102 102 115 109 109 109 109 109 206 109 103 109 109 109 109 109 103 101 101 101 101 101 101 101 101 103 102 102 102 102 102 102 102 103 101
103 102 102 102 102 102 102 102 133 134 135 102 102 102 102 102 102 102 102 102 102 102 102 119 110 110 113 102 102 116 110 110 110 110 113 102 102 116 110 110 110 110 110 110 110 110 110 110 110 110 110 110 110 110 113 102 102 116 110 110 110 110 110 207 110 123 110 110 110 110 110 103 101 101 101 101 101 101 101 101 103 102 102 102 102 102 102 102 103 101
103 102 102 102 102 102 102 102 136 137 138 102 102 102 102 102 102 102 102 102 102 102 102 102 102 102 102 102 102 102 102 102 102 102 102 102 102 102 102 102 102 102 102 102 102 102 102 102 102 102 102 102 102 102 102 102 102 102 102 102 102 102 102 102 102 124 102 130 131 132 102 103 101 101 101 101 101 101 101 101 103 102 102 102 102 102 102 102 103 101
103 102 102 102 102 102 102 102 102 102 102 102 102 102 102 102 102 102 102 102 102 102 102 102 102 102 102 102 102 102 102 102 102 102 102 102 102 102 102 102 102 102 102 102 102 102 102 102 102 102 102 102 102 102 102 102 102 102 102 102 102 102 102 102 102 125 102 133 134 135 102 103 101 101 101 101 101 101 101 101 103 102 102 102 102 102 102 102 103 101
103 102 102 102 102 102 102 102 102 102 102 102 102 102 102 102 102 102 102 102 102 102 102 102 102 102 102 102 102 102 102 102 102 102 102 102 102 102 102 102 102 102 102 102 102 102 102 102 102 102 102 102 102 102 102 102 102 102 102 102 102 102 102 102 102 102 102 136 137 138 102 103 101 101 101 101 101 101 101 101 103 102 102 102 102 102 102 102 103 101
103 102 102 102 102 102 102 102 102 102 102 102 102 102 102 102 102 102 102 102 102 102 102 102 102 102 102 102 102 102 102 102 102 102 102 102 102 102 102 102 102 102 102 102 102 102 102 102 102 102 102 102 102 102 102 102 102 102 102 102 102 102 102 102 102 102 102 102 102 102 102 103 101 101 101 101 101 101 101 101 103 102 102 102 102 102 102 102 103 101
103 102 102 102 102 102 102 102 102 102 102 102 102 102 102 102 102 102 102 102 102 102 102 105 104 104 104 104 104 111 102 102 102 102 114 104 104 104 104 104 104 104 104 104 104 104 111 102 102 102 114 104 104 104 104 104 104 104 104 104 104 104 104 104 104 104 104 104 104 104 104 103 101 101 101 101 101 101 101 101 103 102 102 102 102 102 102 102 103 101
103 102 102 130 131 132 102 102 102 102 102 102 130 131 132 102 102 102 102 102 102 102 102 103 109 109 109 109 109 112 102 102 102 102 115 109 109 109 109 109 109 109 109 109 109 109 112 102 102 102 115 109 109 109 103 109 109 109 109 109 109 103 109 109 109 109 109 109 109 109 109 103 101 101 101 101 101 101 101 101 103 102 102 102 102 102 102 102 103 101
103 102 102 133 134 135 102 102 102 102 102 102 133 134 135 102 102 102 102 102 102 102 102 103 110 110 110 110 110 113 102 102 102 102 116 110 110 110 110 110 110 110 110 110 110 110 113 102 102 102 116 110 110 110 103 110 110 110 110 110 110 103 110 110 110 110 110 110 110 110 110 103 101 101 101 101 101 101 101 101 103 102 102 102 102 102 102 102 103 101
103 102 102 136 137 138 102 102 102 102 102 102 136 137 138 102 102 102 102 102 102 102 102 103 101 101 101 101 101 214 215 216 216 217 218 101 101 101 101 101 101 103 102 102 102 102 102 102 102 102 102 102 102 102 103 102 102 102 102 102 102 103 102 102 102 102 102 102 102 102 102 103 101 101 101 101 101 101 101 101 103 102 102 102 102 102 102 102 103 101
103 102 102 102 102 102 102 102 102 102 102 102 102 102 102 102 102 102 102 102 102 102 102 103 101 101 101 101 101 219 220 221 221 222 223 101 101 101 101 101 101 103 102 102 102 102 102 102 102 102 102 102 102 102 103 102 102 102 102 102 102 103 102 102 102 102 102 102 102 102 102 103 101 101 101 101 101 101 101 101 103 102 102 102 102 102 102 102 103 101
103 102 102 102 102 102 102 102 102 102 102 102 102 102 102 102 102 102 102 102 102 102 102 103 101 101 101 101 101 224 225 225 225 225 226 101 101 101 101 101 101 103 102 102 102 102 102 102 102 102 102 102 102 102 103 102 102 102 102 102 102 103 102 184 185 102 102 102 102 184 185 103 101 101 101 101 101 101 101 101 103 102 102 102 102 102 102 102 103 101
103 102 102 102 102 102 102 102 102 102 102 102 102 102 102 102 102 102 102 102 102 102 102 103 101 101 101 101 101 227 228 228 228 228 229 101 101 101 101 101 101 103 102 102 102 102 102 102 102 102 102 102 102 102 117 104 104 104 104 104 104 120 102 186 187 102 176 177 102 186 187 103 101 101 101 101 101 101 101 101 103 102 102 102 102 102 102 102 103 101
103 102 102 102 102 102 102 102 102 102 102 102 102 102 102 102 102 102 102 102 102 102 102 103 101 101 101 101 101 230 231 231 231 231 232 101 101 101 101 101 101 103 102 102 102 102 102 102 102 102 102 102 102 102 118 109 188 189 190 191 109 121 102 102 102 102 178 179 102 102 102 103 101 101 101 101 101 101 101 101 103 102 102 102 102 102 102 102 103 101
103 102 102 130 131 132 102 102 102 102 102 102 130 131 132 102 102 102 102 102 102 102 102 103 101 101 101 101 101 233 234 234 234 234 235 101 101 101 101 101 101 103 174 102 102 102 102 102 102 102 102 102 102 102 119 110 192 193 194 195 110 122 102 102 102 102 102 102 102 102 102 103 101 101 101 101 101 101 101 101 103 102 102 102 102 102 102 102 103 101
103 102 102 133 134 135 102 102 102 102 102 102 133 134 135 102 102 102 102 102 102 102 102 103 101 101 101 101 101 236 237 237 237 237 238 101 101 101 101 101 101 103 175 102 102 102 102 102 102 102 102 102 102 102 102 102 102 102 102 102 102 102 102 184 185 102 184 185 102 184 185 103 101 101 101 101 101 101 101 101 103 102 102 102 102 102 102 102 103 101
103 102 102 136 137 138 102 102 102 102 102 102 136 137 138 102 102 102 102 102 102 102 102 103 101 101 101 101 101 239 240 241 241 242 243 101 101 101 101 101 101 103 102 102 102 102 102 102 102 102 102 102 102 102 102 102 102 102 102 102 102 102 102 186 187 102 186 187 102 186 187 103 101 101 101 101 101 101 101 101 103 102 102 102 102 102 102 102 103 101
103 102 102 102 102 102 102 102 102 102 102 102 102 102 102 102 102 102 102 102 102 102 102 103 101 101 101 101 101 101 101 101 101 101 101 101 101 101 101 101 101 103 172 102 102 102 102 102 102 102 102 102 102 102 102 102 102 102 102 102 102 102 102 102 102 102 102 102 102 102 102 103 101 101 101 101 101 101 101 101 103 102 102 102 102 102 102 102 103 101
103 102 102 102 102 102 102 102 102 102 102 102 102 102 102 102 102 102 102 102 102 102 102 103 101 101 101 101 101 101 101 101 101 101 101 101 101 101 101 101 101 103 173 102 102 102 102 102 102 102 102 102 102 102 102 102 102 102 102 102 102 102 102 102 102 102 102 102 102 102 102 103 101 101 101 101 101 101 101 101 103 102 102 102 102 102 102 102 103 101
103 102 102 102 102 102 102 102 102 102 102 102 102 102 102 102 102 102 102 102 102 102 102 103 101 101 101 101 101 101 101 101 101 101 101 101 101 101 101 101 101 103 102 102 102 102 102 102 102 102 102 102 102 102 102 102 102 102 102 102 102 102 102 184 185 102 184 185 102 184 185 103 101 101 101 101 101 101 101 101 103 102 102 102 102 102 102 102 103 101
103 166 102 102 102 102 102 102 102 102 102 102 102 102 102 102 102 102 102 102 102 102 168 103 101 101 101 101 101 101 101 101 101 101 101 101 101 101 101 101 101 103 170 102 102 102 180 181 102 102 180 181 102 102 180 181 102 102 180 181 102 102 102 186 187 102 186 187 102 186 187 103 101 101 101 101 101 101 101 101 103 102 102 102 102 102 102 102 103 101
103 167 102 102 102 102 102 102 102 102 102 102 102 102 102 102 102 102 102 102 102 102 169 103 101 101 101 101 101 101 101 101 101 101 101 101 101 101 101 101 101 103 171 102 102 102 182 183 102 102 182 183 102 102 182 183 102 102 182 183 102 102 102 102 102 102 102 102 102 102 102 103 101 101 101 101 101 101 101 101 103 102 102 102 102 102 102 102 103 101
108 104 104 104 104 104 104 104 104 104 104 104 104 104 104 104 111 102 102 102 114 104 104 104 104 104 104 104 104 104 104 104 104 104 104 104 104 104 104 104 104 104 104 104 104 104 104 104 104 104 104 104 104 104 104 104 104 104 104 104 104 104 104 104 104 104 104 104 104 104 104 107 101 101 101 101 101 101 101 101 108 104 111 102 102 102 114 104 107 101
101 101 101 101 101 101 101 101 101 101 101 101 101 101 101 101 101 101 101 101 101 101 101 101 101 101 101 101 101 101 101 101 101 101 101 101 101 101 101 101 101 101 101 101 101 101 101 101 101 101 101 101 101 101 101 101 101 101 101 101 101 101 101 101 101 101 101 101 101 101 101 101 101 101 101 101 101 101 101 101 101 101 101 101 101 101 101 101 101 101
